R 700 800
NO ./tex/bluestone.xpm
SO ./tex/bluestone.xpm
WE ./tex/redbrick.xpm
EA ./tex/bluestone.xpm
S ./tex/barrel.xpm
F 4,201,162
C 0,0,0

1111111111111111111111111111
1000000000000000000000000001
1000000000000000200000000001
1000000000000000200000000001
1000000000000000200000000001
1000200000000000000000000001
1000000000001110000000000001
1000000000000000000000000001
1000000002000000000N00000001
1000000002000000000000000001
1000000002000000000000000001
1000000000000000000000000001
1111111111111111111111111111
