R 6000 6000
NO textures/WALL68.xpm
SO textures/greystone.xpm
WE textures/bluestone.xpm
EA textures/WALL31.xpm
S textures/coins.xpm
F 255,255,0
C 0,0,0

        1111111111111111111111111111
        1222222222222221222222222221
        1000002000001001200000000001
        100000000001001200000000001
        1000000000001000200000000001
        10002000N0002111000000020001
		1111111111111111111111111111

		1111111111111111111111111111
        1000000000000001111100000001
        1000000020020101   100000001
        1000000000000001   100000001
        1000000000000100111100000201
        1000000002220111100200000001
        10000000000001  100000000001
        11111111111111  111111111111