R 700 800
NO ./tex/bluestone.xpm
SO ./tex/bluestone.xpm
WE ./tex/redbrick.xpm
EA ./tex/bluestone.xpm
S ./tex/barrel.xpm
F 4,201,162
C 0,0,0

    11111111111111111
    10000000000000001
    10201110011110001
    10000100000002001
    1000000N000000001
    10222000020000001
    10000000000000001
    11111111111111111
